EEEE-EMo|ETEMEM--ooTTME|M-B-?o|Bo|E|o?|TTM-MBBB?-?-oMT-E-B?-EToTT??-||TM||BEToo|?E-BTMT-?T--MEBE-?Mo?oTTEoBTM-|?o-?---BB||E?MTM?E|-BE-|oEE-T|TToBBM?--oBB??|oMB?EE----MMEoM||?|-T-BBT|E?TMo-BM||?E|-----
|-o?BMTMo|?oM?EE?o??M-|B?-?oEEBE-E?T-?E|-B?-E|EB-?o-T-?|MB?ME|oE?o?E--T?o?oMMMBoM---BTo?MT-??oo-M?oToT--M-M?-E-?E|-BME|M?M|?B|-?--o|oMM?Mo|?--B-T?T-|oEETM?ETE-TTBM|E-oMBEMoE|-BMTTBB||o?-|BTo?B-oE|-?To
X-MB?B--T-o?MBToM|?ETBMo|EE|M?ET-o-oMBME|--|--BB-|--?|?BEE||TEEB||?B|B|M-?--EEMM|-EE-|-TB???-TT?TM||-To?|MMBEoM|oTE?-T-T?TEB|E--M?B-E-M-T---BEE??-?T??oT?B|MoBM?||-To|ME?|M?E-?TE-||BBB-|EM?EB?|E-oBMTEM
X?|---E||Eo-E|-|-E---o---M---B--T----Mo--T---EMo-E---M-TET---EMT--MMET--MMT|-M-|EE---o-MTTEE-T--Eoo-E|M--MoMoE|-|--T-M---M-Bo-E---|-Eo|T--MMEB-MET--T--o-E-M-o-oE------o----|--M|MMET-o--|M--ET-o-MT--T-
M-MT-oM-ET-T----T--T----EM|-o-Mo-E|TM-oEToEE-E-|-oMoo-M-o-|-E-||E--E-MoTE-M-TT-E----TMMoo-T-M|M|-M-|EE-oM|----To-EM-------?M--|---o--EE--|-|-EETEM----Eo--|T-E||Eo|--M-M----o?o--?--EE|TTo------o|E|-M-E
oEBo--M-ooMM-T-MM--||o----o---o||--TTMToo|-Mo--E--T-|T|--M-TEo|--E-----MM-oo--o------BE-o--M---o--|-ET-T||M-|MT---||Eo-T--E--|-oEoTo|---T-|-o-oo|---||--T-o-o-MEE?-o-MoTT-M|o-E||oT--o-M--M|--|--MM-o-o-
TT---EMo|MMM-TT-|-|Eo-|T|-|MT--oE|oEM-TTTToM-B?----|Eo--T|--T---E---T||-E-----|T--E-oM|-M-T-o-|----MEMooo-o-E-|---E---MM-TM|||--T--|-M---ooT------M-oEET|-M-EooMT---o|T---E-oo----oEEM-oT---|--o|E-M---o
B--EE-oT--|o--|--|MEMM--T--|M-|-TT-E-M-T-EE-|Eo?-----TT----EMTo|---o--||-|o-E|EM-EE--E-T--|-T|-MTMooET-|T|---T-o-----Too|MT--T-|EMEE|-E-ME|-ME-BEoB-E---M-Mo-|Mo-EET-oT---|M-E-M-|-Eo-To|E--oTM|M-oEM|Tv
XoMT-TEo|---o--E---BooTETT-oT-||E---T--E-|-|-----?Eoo-EMo||-|T-EME--|---o-oT---|-o|o-EoETo--M----|-MT|---o-o-----BEM-|oMTEoM-To--T--EEBB-o-|E-T-oEM||M|---T-----E-o|-TT-To|--T--ToM-ET-|M-E-ToET--|TTo-B
o?E||ooM|M---o-o--To-|-oT-TT---T-ETEEMM--M-T-o--?EoTT------|oE|MM-TE---oTooMEoTM--M--MEE-T---E--oMM--ToEM-|-o-|-MM----|----TE-EMo---MEBo-M----M-oT---EM-E--||-|o|oE----o--Mo|-------M-|T-------T-EoT-M--
o--TTE|--oM-M---|MEo---o--o-T-----|--M-oToo|-oE|MoMMoT-oo|---M-E---EE-B-E----E-oE-M|T-ET-MM-MET-T--ET---E--T|oME-?--M|TM---o-Mo--oE--oEBoM--T-M-TT|TM-TE--|---M----o|-T-E-METM--o--|--EM-TET--M-T-T--M?-
|BTE-ETTT--BM-|-E-o|-||--o-T-MoT-o|TMT-o---|E--oEMT-|-E?MME-||----|M--E-T|TMoE-T|--EET-||-M|MMo---E?E-TT---||---|E||-o-|--oE-|-|---o|T---|----M----|-M||-o-E--|TT|--M---M--E-E|-EET-E-|E-EET-M-|ET-MM-M|
MB---T-EoEMB--T--|E----oT|oEM-E-M----|E---o-E-TE-oEoT---ETM-TTETET-To-M|--TET|MEEE--TTo-|-E-Mo--|ETE-?-E-oE---EM|-|EM-||M|TE--E-o|T|TTEE||MT-|-TE-MM|--o-T|EEE--M|--o-o-----E-|--|o-o-|-MM|E|MT|---T|-|M
-MB---|TT-o-T|-oT-T--T|-T-M-E|EEMT|-T|TT|ToMo---M-TooT|--T-ET|T--T-TEMMTT-E--M--EMEo|T-M---||--E-E-oo-TTo|T|-oME-E---M-TT-MT-M---MTMTTTEo-E-o|EoEE-oTE--oMM-o--|---oETT-TEMT----T-T-EooT-T--M-TMoTo|o-EX
moEMXX--X-o-|-ME--|E-|TT-o-X-E-X-----|-|X|MXooM-M-|--T--TM-o|X|EMMoo-E--XEE---TXEEoT-|TET--T--M--E-M---|EE|--M--MME-E-oMX-ETX-To--|-|-|ooMETo-T-XMMo-TXX--E----o----X|oE-M---E-E|o|-MoMME|EoM-o-E--TMoMo
XXXXXXXXXXXXXXXXXXXXXXXXXXXXXXXXXXXXXXXXXXXXXXXXXXXXXXXXXXXXXXXXXXXXXXXXXXXXXXXXXXXXXXXXXXXXXXXXXXXXXXXXXXXXXXXXXXXXXXXXXXXXXXXXXXXXXXXXXXXXXXXXXXXXXXXXXXXXXXXXXXXXXXXXXXXXXXXXXXXXXXXXXXXXXXXXXXXXXXXX
